                   .:                     :,                                          
,:::::::: ::`      :::                   :::                                          
,:::::::: ::`      :::                   :::                                          
.,,:::,,, ::`.:,   ... .. .:,     .:. ..`... ..`   ..   .:,    .. ::  .::,     .:,`   
   ,::    :::::::  ::, :::::::  `:::::::.,:: :::  ::: .::::::  ::::: ::::::  .::::::  
   ,::    :::::::: ::, :::::::: ::::::::.,:: :::  ::: :::,:::, ::::: ::::::, :::::::: 
   ,::    :::  ::: ::, :::  :::`::.  :::.,::  ::,`::`:::   ::: :::  `::,`   :::   ::: 
   ,::    ::.  ::: ::, ::`  :::.::    ::.,::  :::::: ::::::::: ::`   :::::: ::::::::: 
   ,::    ::.  ::: ::, ::`  :::.::    ::.,::  .::::: ::::::::: ::`    ::::::::::::::: 
   ,::    ::.  ::: ::, ::`  ::: ::: `:::.,::   ::::  :::`  ,,, ::`  .::  :::.::.  ,,, 
   ,::    ::.  ::: ::, ::`  ::: ::::::::.,::   ::::   :::::::` ::`   ::::::: :::::::. 
   ,::    ::.  ::: ::, ::`  :::  :::::::`,::    ::.    :::::`  ::`   ::::::   :::::.  
                                ::,  ,::                               ``             
                                ::::::::                                              
                                 ::::::                                               
                                  `,,`


https://www.thingiverse.com/thing:2746633
Floor mount float switch by DjSuresh is licensed under the Creative Commons - Attribution - Share Alike license.
http://creativecommons.org/licenses/by-sa/3.0/

# Summary

This thing was made with Tinkercad. Edit it online https://www.tinkercad.com/things/1oEyNe6EoNE